Question	Answer	Source	Metadata
Gay	Who is gay?	NA.  NA.
gay	Who is gay?	NA.  NA.
Ryan is gay	No it is you	NA.  NA.
Jimmy is gay	No it is you	NA.  NA.
You are gay	No you are gay	NA.  NA.
Who is gayer?	The one who ask this question	NA.  NA.
Who is gayest?	The one who ask this question	NA.  NA.
Good morning	Good morning	NA.  NA.
Good morning!	Good morning	NA.  NA.
Good Morning	Good morning	NA.  NA.
good morning	Good morning	NA.  NA.
Good morning bong	Good morning	NA.  NA.
Good morning B	Good morning	NA.  NA.
Good morning 🌞	Good morning	NA.  NA.
Good morning ☕	Good morning	NA.  NA.
Good morning 🌞	Good morning	NA.  NA.
Good morning ☀️	Good morning	NA.  NA.
Good morning 🌄	Good morning	NA.  NA.
Good morning 🌼	Good morning	NA.  NA.
Good morning 🍀	Good morning	NA.  NA.
Good morning ❤️	Good morning	NA.  NA.
Good morning 😃	Good morning	NA.  NA.
Good morning 🌻	Good morning	NA.  NA.
Good morning all	Good morning	NA.  NA.
Good morning 🌅	Good morning	NA.  NA.
Good morning 🌥	Good morning	NA.  NA.
Good morning❣️	Good morning	NA.  NA.
Morning	Good morning	NA.  NA.
morning!	Good morning	NA.  NA.
Morning!	Good morning	NA.  NA.
Morning.	Good morning	NA.  NA.
Morning bong	Good morning	NA.  NA.
Morning B	Good morning	NA.  NA.
Morning 🌞	Good morning	NA.  NA.
Morning ☕	Good morning	NA.  NA.
Morning 🌞	Good morning	NA.  NA.
Morning ☀️	Good morning	NA.  NA.
Morning 🌄	Good morning	NA.  NA.
Morning 🌼	Good morning	NA.  NA.
Morning 🍀	Good morning	NA.  NA.
Morning ❤️	Good morning	NA.  NA.
Morning 😃	Good morning	NA.  NA.
Morning 🌻	Good morning	NA.  NA.
Morning all	Good morning	NA.  NA.
Morning 🌅	Good morning	NA.  NA.
Morning 🌥	Good morning	NA.  NA.
Morning❣️	Good morning	NA.  NA.
